BAD	B AE D
COULD	K UH D
GET	G EH T
GET(2)	G IH T
GO	G OW
GOOD	G UH D
GOOD(2)	G IH D
JUICE	JH UW S
JUICE?	JH UW S
NERO	N IH R OW
PLEASE	P L IY Z
ROBOT	R OW B AA T
ROBOT(2)	R OW B AH T
SLEEP	S L IY P
THANK	TH AE NG K
THANKS	TH AE NG K S
THE	DH AH
THE(2)	DH IY
TO	T UW
TO(2)	T IH
TO(3)	T AH
UP	AH P
WAKE	W EY K
YOU	Y UW
